.........
.........
...BB....
.PB......
.........
.........