.WWWWWWWW
WWDRRWRRW
WRRRRRRRW
WRRWRRRDW
WRDRRRWWW
WWWWWWW..