.WWWWW
WWRRRW
WRRRRW
WRRWWW
WWRRW.
WWRRW.
WRRRWW
WRRRDW
WWWRRW
..WDRW
..WWWW