.........
...B.....
.BB......
P...B.B..
.........
.........
.........
.........