...WWWWW...
WWWWRRRW...
WRRWRRRWWWW
WRRRRRRRRRW
WRRRWRRRWRW
WWWRWRRRWRW
.WRRWWWWWRW
.WRRDDDDDRW
.WWWWWWWWWW