...RRR...
RR.RRR...
RRRRRRRRR
RRR.RRR.R
..R.RRR.R
.RR.....R
.RRDDDDDR
.........