........
...DB...
...BB...
...BPBB.
...B....
........