WWWWWWWW
WRRDRRRW
WRRDDRRW
WRRDRDDW
WRRDRRRW
WWWWWWWW